1111111111
10P0000001
1011111111
1000000001
1011111101
1CCF000001
1C11011111
1F100010E1
1000100011
1111111111